55 30
#############
#...........#    ########    ##x#####################
#...s...s...######..g...#    #......................#
#.....k........d........#    #......................#
#...........######...i..#    #......................#
#...........#    #......#    #......................#
#...........#    #...e..#    ##############.#########
#..........g#    #......#                 #.#
#####..######    ###..###                 #.#
    #..#           #..#                   #.#
    #..#           #..#                   #.#
    #..#         ###..###            ######d#######
  ###..####      #......#            #............#
  #.......#      #......#            #............#
  #.......#      #......##############.......g....#
  #.......#      #...........................s....#
  #.......#      #...c..##############..........s.#
  #.......#      #......#            #.......s....#
  #...@...#      #......#            #.......s...k#
  #########      ########            ##############













