26 20
#############   #####
#...........#   #....
#.@.......###   #.###
#......s.s.k#   #.#
#.........##### #.#
#...........d.# #.#
#############.# #.#
            #.# #.#
#############.# #.###
#...........b.# #...#
#.....i.....#######d#
#...........# #.....#
#...#####...b.b..k..#
#.s.#   #.s.# #.....#
#####   ##### #######












