25 20
#############
#...........#    ########
#...s...s...######......#
#.......................#
#...........######...i..#
#.....s.....#    #......#
#...........#    #......#
#...........#    #......#
#####..######    ###..###
    #..#           #..#
    #..#           #..#
    #..#          ##..##
  ###..####      #......#
  #...k...#      #......#
  #.......#      #...i..#
  #...i...#      #......#
  #.......#      #......#
  #.......#      #......#
  #...@...#      #......#
  #########       ######
